*******************
*                 *
* ** *** * *** ** *
*                 *
* ** * ***** * ** *
*    *   *   *    *
**** *** * *** ****
**** *+++++++* ****
**** *+**+**+* ****
*+++ ++*+++*++ +++*
**** *+**+**+* ****
**** *+++++++* ****
**** * ***** * ****
*        *        *
* ** *** * *** ** *
*  *     +     *  *
** * * ***** * * **
*    *   *   *    *
* ****** * ****** *
*                 *
*******************
